ALPHABETS -> A | B | C | D | E | F | G | H | I | J | K | L | M | N | O | P | Q | R | S | T | U | V | W | X | Y | Z | a | b | c | d | e | f | g | h | i | j | k | l | m | n | o | p | q | r | s | t | u | v | w | x | y | z
DIGIT -> 0 | 1 | 2 | 3 | 4 | 5 | 6 | 7 | 8 | 9
OP -> + | - | * | ** | / | % | < | <= | > | >= | == | & | ^ |  && | ORBITWISETERM | ORLOGTERM
OTHERS -> DOLLARSIGN | UNDERSCORE | TITIK | SERUTERM | BO | BC | CBO | CBC | OP
DOLLARSIGN -> $
UNDERSCORE -> _
NEWLINETERM -> \n
BO -> (
BC -> )
CBO -> {
CBC -> }
KOMA -> ,
TITIK -> .
TTKOMA -> ;
SERUTERM -> !
COMMENTOPEN -> /*
COMMENTCLOSE -> */
COMMENTLINE -> //
NANTERM -> NaN
ORBITWISETERM -> |
ORLOGTERM -> ||
ASSIGN -> =
FUNCTIONTERM -> function
UNDEFINEDTERM -> undefined
NULLTERM -> null
RETURNTERM -> return
CONSTTERM -> const
VARTERM -> var
LETTERM -> let
FORTERM -> for


VARIABLE -> CONST | VAR | LET

CONST -> CONSTTERM IDENTIFIER ASSIGN VALUES

VAR -> VARTERM IDENTIFIER ASSIGN VALUES

LET -> LETTERM IDENTIFIER ASSIGN VALUES

NEWLINE -> NEWLINE NEWLINE | NEWLINETERM

CREMENT -> IDENTIFIER PLUSPLUSTERM | PLUSPLUSTERM IDENTIFIER | IDENTIFIER MINUSMINUSTERM | MINUSMINUSTERM IDENTIFIER

BOOLEAN -> SERUTERM BOOLEANSUB | BOOLEANSUB
BOOLEANSUB -> TRUETERM | FALSETERM | VALUES OP VALUES

IDENTIFIER -> IDENTIFIERSTART IDENTIFIERBODY | IDENTIFIERSTART
IDENTIFIERSTART -> DOLLARSIGN | UNDERSCORE | ALPHABETS
IDENTIFIERBODY -> IDENTIFIERBODY IDENTIFIERBODY | IDENTIFIERSCRIPT
IDENTIFIERSCRIPT -> ALPHABETS | DIGIT | DOLLARSIGN | UNDERSCORE

TEKS -> TEKS TEKS | ALPHABETS | DIGIT | OTHERS
STRING -> PETIKDUA TEKS PETTIKDUA | PETIKSATU TEKS PETIKSATU

EKSPONEN -> e+ | e-
NUMBERVAL -> NUMBERVAL NUMBERVAL | DIGIT
NUMBERS -> NUMBERVAL | NUMBERVAL TITIK NUMBERVAL | NUMBERVAL EKSPONEN NUMBERVAL | NANTERM

COMMENT -> COMMENTOPEN TEKS COMMENTCLOSE | COMMENTLINE TEKS

TITLEFUNC -> IDENTIFIER BO FUNCVAR BC | IDENTIFIER BO BC
FUNCVAR -> FUNCFAR KOMA FUNCFAR | VAR
FUNCTIONHEADER -> FUNCTIONTERM TITLEFUNC
FUNCTION -> FUNCTIONHEADER CBO MAIN CBC

//MAIN tuh harusnya yang jadi main kita, tapi gatau gimana sih ngebentuk grammarnya gimana
//struktur kasar return

RETURN -> RETURNTERM | RETURNTERM VALUES | RETURNTERM
VALUES -> VALUES KOMA VALUES | VALUE | VAR
VALUE -> STRING | NUMBER | BOOLEAN | ARRAY | NULLTERM | TITLEFUNC | UNDEFINEDTERM | BO VALUES BC | VALUES OP VALUES

TRY -> TRYTERM CBO MAIN CBC CATCH | TRYTERM CBO MAIN CBC CATCH FINALLY

CATCH -> CATCHTERM BO IDENTIFIER BO CBO MAIN CBC

FINALLY -> CATCHTERM CBO MAIN CBC

THROW -> THROWTERM THROWABLES
THROWABLES -> STRING | NUMBER | BOOLEAN | OBJECT


// BELUM BERES
FORLOOPHEADER -> VARIABLE TTKOMA BOOLEAN TTKOMA CREMENT | FORLOOPHEADERDUA | TTKOMA TTKOMA TTKOMA 
FORLOOP -> FORTERM BO FORLOOPHEADER BC CBO MAIN CBC | FORTERM BO FORLOOPHEADER BC

