Terminals:
A B C D E F G H I J K L M N O P Q R S T U V W X Y Z a b c d e f g h i j k l m n o p q r s t u v w x y z 0 1 2 3 4 5 6 7 8 9 + - * ** / % < <= > >= == & ^ && | ||
$ _ . ! ( ) { } \n [ ] , ; : ! /* */ // Nan = function undefined null return const var for true false if else " ' throw try catch finally
Productions:
ALPHABETS -> A | B | C | D | E | F | G | H | I | J | K | L | M | N | O | P | Q | R | S | T | U | V | W | X | Y | Z | a | b | c | d | e | f | g | h | i | j | k | l | m | n | o | p | q | r | s | t | u | v | w | x | y | z~
DIGIT -> 0 | 1 | 2 | 3 | 4 | 5 | 6 | 7 | 8 | 9~
OP -> + | - | * | ** | / | % | < | <= | > | >= | == | & | ^ | && | ORBITWISETERM | ORLOGTERM~
OTHERS -> DOLLARSIGN | UNDERSCORE | TITIK | SERUTERM | BO | BC | CBO | CBC | OP~
DOLLARSIGN -> $~
UNDERSCORE -> _~
NEWLINETERM -> newline~
BO -> (~
BC -> )~
CBO -> {~
CBC -> }~
RBO -> [~
RBC -> ]~
KOMA -> ,~
TITIK -> .~
TTKOMA -> ;~
TITIKDUA -> :~
SERUTERM -> !~
COMMENTOPEN -> /*~
COMMENTCLOSE -> */~
COMMENTLINE -> //~
NANTERM -> NaN~
ORBITWISETERM -> |~
ORLOGTERM -> ||~
ASSIGN -> =~
FUNCTIONTERM -> function~
UNDEFINEDTERM -> undefined~
NULLTERM -> null~
RETURNTERM -> return~
CONSTTERM -> const~
VARTERM -> var~
LETTERM -> let~
FORTERM -> for~
TRUETERM -> true~
FALSETERM -> false~
IFTERM -> if~
ELSETERM -> else~
PETIKDUA -> "~
PETIKSATU -> '~
THROWTERM -> throw~
TRYTERM -> try~
CATCHTERM -> catch~
FINALLYTERM -> finally~
VARIABLE -> CONST | VAR | LET~
CONST -> CONSTTERM IDENTIFIER ASSIGN VALUE | CONSTTERM IDENTIFIER~
VAR -> VARTERM IDENTIFIER ASSIGN VALUE | VARTERM IDENTIFIER~
LET -> LETTERM IDENTIFIER ASSIGN VALUE | LETTERM IDENTIFIER~
NEWLINE -> NEWLINE NEWLINE | NEWLINETERM~
CREMENT -> IDENTIFIER PLUSPLUSTERM | PLUSPLUSTERM IDENTIFIER | IDENTIFIER MINUSMINUSTERM | MINUSMINUSTERM IDENTIFIER~
IDENTIFIER -> IDENTIFIERSTART IDENTIFIERBODY | IDENTIFIERSTART~
IDENTIFIERSTART -> DOLLARSIGN | UNDERSCORE | ALPHABETS~
IDENTIFIERBODY -> IDENTIFIERBODY IDENTIFIERBODY | IDENTIFIERSCRIPT~
IDENTIFIERSCRIPT -> ALPHABETS | DIGIT | DOLLARSIGN | UNDERSCORE~
TEKS -> TEKS TEKS | ALPHABETS | DIGIT | OTHERS~
STRING -> PETIKDUA TEKS PETIKDUA | PETIKSATU TEKS PETIKSATU~
EKSPONEN -> e+ | e-~
NUMBERVAL -> NUMBERVAL NUMBERVAL | DIGIT~
NUMBERS -> NUMBERVAL | NUMBERVAL TITIK NUMBERVAL | NUMBERVAL EKSPONEN NUMBERVAL | NANTERM~
ARRAY -> BO VALUES BC | BO BC | RBO VALUES RBC | RBO RBC~
BOOLEAN -> TRUETERM | FALSETERM~
PARAGRAPH -> TEKS | PARAGRAPH NEWLINE PARAGRAPH | NEWLINE PARAGRAPH | PARAGRAPH NEWLINE~
COMMENT -> COMMENTOPEN PARAGRAPH COMMENTCLOSE | COMMENTLINE TEKS~
OBJECT -> CBO OBJECTSAMPLE CBC | CBO CBC~
OBJECTSAMPLE -> OBJECTSAMPLESUB KOMA OBJECTSAMPLESUB | OBJECTSAMPLESUB~
OBJECTSAMPLESUB -> IDENTIFIER TITIKDUA VALUE~
TITLEFUNC -> IDENTIFIER BO FUNCVAR BC | IDENTIFIER BO BC~
FUNCVAR -> FUNCFAR KOMA FUNCFAR | IDENTIFIER~
FUNCTIONHEADER -> FUNCTIONTERM TITLEFUNC~
FUNCTION -> FUNCTIONHEADER CBO MAIN CBC~
MAIN -> MAIN NEWLINE MAIN | MAIN NEWLINE | IFFUNC | FORFUNC | WHILEFUNC | FUNCTION | RETURN | COMMENT | NULLTERM | UNDEFINEDTERM | VARIABLE | VALUES~ 
RETURN -> RETURNTERM | RETURNTERM VALUES | RETURNTERM~
VALUES -> VALUES KOMA VALUES | VALUE | SERUTERM VALUE~
VALUE -> STRING | NUMBERS | BOOLEAN | ARRAY | NULLTERM | OBJECT | TITLEFUNC | UNDEFINEDTERM | VALUES OP VALUES | IDENTIFIER | ARRAYMEMBER~
ARRAYMEMBER -> IDENTIFIER RBO NUMBERVAL RBC | ARRAY RBO NUMBERVAL RBC~
TRY -> TRYTERM CBO MAIN CBC CATCH | TRYTERM CBO MAIN CBC CATCH FINALLY~
CATCH -> CATCHTERM CBO MAIN CBC | CATCHTERM BO IDENTIFIER BO CBO MAIN CBC~
FINALLY -> FINALLYTERM CBO MAIN CBC~
THROW -> THROWTERM VALUES~
IFFUNC -> IFTERM BO VALUES BC MAIN | IFTERM BO VALUES BC MAIN ELSE~
ELSE -> ELSETERM MAIN~
FORLOOPHEADER -> VARIABLE TTKOMA BOOLEAN TTKOMA CREMENT | FORLOOPHEADERDUA | TTKOMA TTKOMA TTKOMA~
FORLOOP -> FORTERM BO FORLOOPHEADER BC CBO MAIN CBC | FORTERM BO FORLOOPHEADER BC