Terminals:
a 1 + - * ** / % < <= > >= == & ^ && | || $ _ . ! ( ) { } [ ] , ; : ! NaN = ? === !== " '
function undefined null return const var let for true false if else throw try catch finally while do in of switch case default break continue delete debugger
Productions:
DIGIT -> 1~
OP -> * | PLUSTERM | MINUSTERM~
OTHERS -> DOLLARSIGN | UNDERSCORE | TITIK | SERUTERM | BO | BC | CBO | CBC | OP~
DOLLARSIGN -> $~
UNDERSCORE -> _~
NEWLINETERM -> newline~
BO -> (~
BC -> )~
CBO -> {~
CBC -> }~
RBO -> [~
RBC -> ]~
KOMA -> ,~
TITIK -> .~
TTKOMA -> ;~
TITIKDUA -> :~
SERUTERM -> !~
NANTERM -> NaN~
ASSIGN -> =~
FUNCTIONTERM -> function~
UNDEFINEDTERM -> undefined~
NULLTERM -> null~
RETURNTERM -> return~
CONSTTERM -> const~
VARTERM -> var~
LETTERM -> let~
FORTERM -> for~
TRUETERM -> true~
FALSETERM -> false~
IFTERM -> if~
ELSETERM -> else~
PETIKDUA -> "~
PETIKSATU -> '~
BACKSLASH -> \~
THROWTERM -> throw~
TRYTERM -> try~
CATCHTERM -> catch~
FINALLYTERM -> finally~
WHILETERM -> while~
DOTERM -> do~
INTERM -> in~
OFTERM -> of~
SWITCHTERM -> switch~
CASETERM -> case~
DEFAULTTERM -> default~
BREAKTERM -> break~
DELETETERM -> delete~
CONTINUETERM -> continue~
QUESTIONMARKTERM -> ?~
PLUSPLUSTERM -> ++~
MINUSMINUSTERM -> --~
PLUSTERM -> +~
MINUSTERM -> -~
VARIABLE -> CONST | VAR | LET~
CONST -> CONSTTERM ASSIGNMENT~
VAR -> VARTERM KOMAMIXIDENTIF~
LET -> LETTERM KOMAMIXIDENTIF | LETTERM ASSIGN VALUES~
KOMAMIXIDENTIF -> KOMAMIXIDENTIF KOMA KOMAMIXIDENTIF | SUBKOMAMIXIDENTIF~
SUBKOMAMIXIDENTIF -> IDENTIFIER | ASSIGNMENT | RECASSIGNIDENT~
RECASSIGNIDENT -> RECASSIGNIDENT ASSIGN RECASSIGNIDENT | IDENTIFIER~
ASSIGNMENT -> ASSIGMENTSUB VALUE | ASSIGMENTSUB FUNCTION | ASSIGMENTSUB FUNCTIONVAR | ASSIGMENTSUB IDENTIFIER BO VALUES BC~ 
ASSIGMENTSUB -> ASSIGMENTSUB ASSIGMENTSUB | OBJECTMEMBER ASSIGN~
ESCAPESQUENCE -> BACKSLASH BACKSLASH | BACKSLASH PETIKSATU | BACKSLASH PETIKDUA~
NEWLINE -> NEWLINE NEWLINE | NEWLINETERM~
CREMENT -> IDENTIFIER PLUSPLUSTERM | PLUSPLUSTERM IDENTIFIER | IDENTIFIER MINUSMINUSTERM | MINUSMINUSTERM IDENTIFIER | CREMENTKURUNG~
CREMENTKURUNG -> BO CREMENT BC | BO CREMENT BC PLUSPLUSTERM | BO CREMENT BC MINUSMINUSTERM | PLUSPLUSTERM BO CREMENT BC | MINUSMINUSTERM BO CREMENT BC~
IDENTIFIER -> a~
STRING -> PETIKDUA PETIKDUA | PETIKSATU PETIKSATU~
EKSPONEN -> e+ | e-~
NUMBERVAL -> NUMBERVAL NUMBERVAL | DIGIT~
NUMBERS -> NUMBERVAL | NUMBERVAL TITIK NUMBERVAL | NUMBERVAL EKSPONEN NUMBERVAL | NANTERM~
ARRAY -> BO VALUES BC | RBO VALUES RBC | RBO RBC~
ARRAYRECURSE -> RBO VALUE RBC | RBO VALUE RBC ARRAYRECURSE~
ARRAYMEMBER -> IDENTIFIER ARRAYRECURSE~
BOOLEAN -> TRUETERM | FALSETERM~
OBJECTRECURSEB -> OBJECTRECURSEB RBO VALUES RBC | RBO VALUES RBC | BO VALUES BC | OBJECTRECURSEB BO VALUES BC~
OBJECTRECURSE -> OBJECTRECURSE TITIK IDENTIFIER | IDENTIFIER | IDENTIFIER OBJECTRECURSEB | OBJECTRECURSE TITIK IDENTIFIER OBJECTRECURSEB~
OBJECTMEMBER -> OBJECTRECURSE~
OBJECT -> CBO OBJECTSAMPLE CBC | CBO CBC~
OBJECTSAMPLE -> OBJECTSAMPLESUB KOMA OBJECTSAMPLE | OBJECTSAMPLESUB | NEWLINE OBJECTSAMPLE | OBJECTSAMPLE NEWLINE~
OBJECTSAMPLESUB -> IDENTIFIER TITIKDUA VALUE~
TITLEFUNC -> IDENTIFIER BO FUNCVAR BC | IDENTIFIER BO BC~
FUNCTIONCALLER -> OBJECTMEMBER BO VALUES BC | OBJECTMEMBER BO BC~
FUNCVAR -> IDENTIFIER KOMA FUNCVAR | ASSIGNMENT KOMA FUNCVAR | IDENTIFIER | ASSIGNMENT~
FUNCTIONHEADER -> FUNCTIONTERM TITLEFUNC~
FUNCTION -> FUNCTIONHEADER CBO MAIN CBC | FUNCTIONHEADER CBO CBC | BO FUNCTION BC | BO FUNCTIONWITHBRACKET BC~
FUNCTIONWITHBRACKET -> FUNCTIONTERM BO FUNCVAR BC CBO MAIN CBC | FUNCTIONTERM BO BC CBO CBC | FUNCTIONTERM BO FUNCTIONVAR BC CBO CBC | FUNCTIONTERM BO BC CBO MAIN CBC~
FUNCTIONVAR -> FUNCTIONTERM BO VALUES BC CBO MAIN CBC | FUNCTIONTERM BO VALUES BC CBO CBC | FUNCTIONTERM BO BC CBO MAIN CBC | FUNCTIONTERM BO BC CBO CBC~
MAIN -> BO MAIN BC | MAIN NEWLINE MAIN | MAIN NEWLINE | NEWLINE MAIN | IFFUNC | FORLOOP | WHILELOOP | FUNCTION | RETURN | VARIABLE | VALUES | ASSIGNMENT | CREMENT | NEWLINE | THROW | SWITCH | TERNARY | DELETE | TRY~
MAINLOOP -> BO MAINLOOP BC | MAINLOOP NEWLINE MAINLOOP | MAINLOOP NEWLINE | NEWLINE MAINLOOP | IFFUNCLOOP | FORLOOP | WHILELOOP | FUNCTION | RETURN | VARIABLE | VALUES | ASSIGNMENT | CREMENT | NEWLINE | THROW | BREAKTERM | CONTINUETERM | TERNARY | DELETE | TRY~
MAINCASE -> BO MAINCASE BC | MAINCASE NEWLINE MAINCASE | MAINCASE NEWLINE | NEWLINE MAINCASE | IFFUNCLOOP | FORLOOP | WHILELOOP | FUNCTION | RETURN | VARIABLE | VALUES | ASSIGNMENT | CREMENT | NEWLINE | THROW | BREAKTERM | CASE | TERNARY | DELETE | TRY~
MAINTERNARY -> BO MAINTERNARY BC | MAINTERNARY NEWLINE MAINTERNARY | MAINTERNARY NEWLINE | NEWLINE MAINTERNARY | VALUES | ASSIGNMENT | CREMENT | NEWLINE | TERNARY | DELETE~
IFARG -> VALUES | ASSIGNMENT~
IFFUNCLOOP -> IFTERM BO IFARG BC MAINLOOP | IFTERM BO IFARG BC CBO MAINLOOP CBC | IFTERM BO IFARG BC CBO CBC | IFFUNCELSELOOP~
IFFUNCELSELOOP -> IFTERM BO IFARG BC MAINLOOP ELSELOOP | IFTERM BO IFARG BC CBO MAINLOOP CBC ELSELOOP | IFTERM BO IFARG BC CBO CBC ELSELOOP~
ELSELOOP -> ELSETERM MAINLOOP | ELSETERM CBO MAINLOOP CBC | ELSETERM CBO CBC | NEWLINE ELSETERM MAINLOOP | NEWLINE ELSETERM CBO MAINLOOP CBC | NEWLINE ELSETERM CBO CBC~
RETURN -> RETURNTERM | RETURNTERM VALUES~
VALUES -> VALUES KOMA VALUES | VALUE~
VALUE -> SERUTERM VALUE | STRING | NUMBERS | BOOLEAN | ARRAY | NULLTERM | OBJECT | FUNCTIONCALLER | UNDEFINEDTERM | VALUE OP VALUE | IDENTIFIER | ARRAYMEMBER | CREMENT | OBJECTMEMBER | NEWLINE VALUE | VALUE NEWLINE | VALUEKURUNG | VALUENEGATIVE~
VALUEKURUNG -> BO VALUE BC | MINUSTERM BO VALUE BC | PLUSTERM BO VALUE BC~ 
VALUENEGATIVE -> MINUSTERM VALUEALT~
VALUEALT -> SERUTERM VALUE | STRING | NUMBERS | BOOLEAN | ARRAY | NULLTERM | OBJECT | FUNCTIONCALLER | UNDEFINEDTERM | IDENTIFIER | ARRAYMEMBER | CREMENT | OBJECTMEMBER | CREMENT | VALUEKURUNG~
TRY -> TRYTERM CBO MAIN CBC CATCH | TRYTERM CBO MAIN CBC NEWLINE CATCH | TRYTERM CBO MAIN CBC CATCH FINALLY | TRYTERM CBO MAIN CBC NEWLINE CATCH FINALLY | TRYTERM CBO MAIN CBC CATCH NEWLINE FINALLY | TRYTERM CBO MAIN CBC NEWLINE CATCH NEWLINE FINALLY | TRYEMPTY~
TRYEMPTY -> TRYTERM CBO CBC CATCH | TRYTERM CBO CBC NEWLINE CATCH | TRYTERM CBO CBC CATCH FINALLY | TRYTERM CBO CBC NEWLINE CATCH FINALLY | TRYTERM CBO CBC CATCH NEWLINE FINALLY| TRYTERM CBO CBC NEWLINE CATCH NEWLINE FINALLY~
CATCH -> CATCHTERM CBO MAIN CBC | CATCHTERM BO IDENTIFIER BC CBO MAIN CBC | CATCHTERM CBO CBC | CATCHTERM BO IDENTIFIER BC CBO CBC~
FINALLY -> FINALLYTERM CBO MAIN CBC | FINALLYTERM CBO CBC~
THROW -> THROWTERM VALUES~
IFFUNC -> IFTERM BO IFARG BC MAIN | IFTERM BO IFARG BC CBO MAIN CBC | IFTERM BO IFARG BC CBO CBC | IFFUNCELSE~
IFFUNCELSE -> IFTERM BO IFARG BC MAIN ELSE | IFTERM BO IFARG BC CBO MAIN CBC ELSE | IFTERM BO IFARG BC CBO CBC ELSE~
ELSE -> ELSETERM MAIN | ELSETERM CBO MAIN CBC | ELSETERM CBO CBC | NEWLINE ELSETERM MAIN | NEWLINE ELSETERM CBO MAIN CBC | NEWLINE ELSETERM CBO CBC~
TERNARY -> VALUE QUESTIONMARKTERM MAINTERNARY TITIKDUA MAINTERNARY~
FORLOOPHEADER -> FORTERM BO ITERABLEFOR BC~
ITERABLEFOR -> ITERABLEFORBAGI | ITERABLEFORBAGI2~
FORLOOP -> FORLOOPHEADER CBO MAINLOOP CBC | FORLOOPHEADER MAINLOOP | FORLOOPHEADER CBO CBC~
ITERABLEFORBAGI -> FORARG1 TTKOMA FORARG2 TTKOMA FORARG3 | FORARG1 TTKOMA FORARG2 TTKOMA | FORARG1 TTKOMA TTKOMA | TTKOMA TTKOMA~
ITERABLEFORBAGI2 -> TTKOMA FORARG2 TTKOMA FORARG3 | TTKOMA FORARG2 TTKOMA | TTKOMA TTKOMA FORARG3 | FORARG1 TTKOMA FORARG3~
FORARG1 -> VALUE | VAR | LET | ASSIGNMENT~
FORARG2 -> VALUE | ASSIGNMENT~
FORARG3 -> CREMENT | VALUE | ASSIGNMENT~
WHILELOOPHEADER -> WHILETERM BO VALUES BC~
WHILELOOP -> WHILELOOPHEADER CBO MAINLOOP CBC | WHILELOOPHEADER CBO CBC | WHILELOOPHEADER MAIN~
DOWHILELOOPHEADER -> DOTERM~
DOWHILELOOP -> DOWHILELOOPHEADER CBO MAINLOOP CBC WHILELOOPHEADER | DOWHILELOOPHEADER MAINLOOP WHILELOOPHEADER~
SWITCH -> SWITCHTERM BO VALUES BC CBO NEWLINE CBC | SWITCHTERM BO VALUES BC CBO CBC | SWITCHTERM BO VALUES BC CBO CASE CBC | SWITCHTERM BO VALUES BC CBO NEWLINE CASE CBC | SWITCHTERM BO VALUES BC CBO DEFAULT CBC | SWITCHTERM BO VALUES BC CBO NEWLINE DEFAULT CBC | SWITCHDUA~
SWITCHDUA -> SWITCHTERM BO VALUES BC CBO CASE DEFAULT CBC | SWITCHTERM BO VALUES BC CBO NEWLINE CASE DEFAULT CBC | SWITCHTERM BO VALUES BC CBO NEWLINE DEFAULT NEWLINE CASE CBC | SWITCHTERM BO VALUES CBO CASE DEFAULT NEWLINE CASE CBC~
CASE -> CASETERM VALUE TITIKDUA MAINCASE | CASETERM BO VALUES BC TITIKDUA MAINCASE | CASETERM VALUES TITIKDUA MAIN NEWLINE BREAKTERM~
DEFAULT -> DEFAULTTERM TITIKDUA MAINCASE | DEFAULTTERM TITIKDUA MAINCASE BREAKTERM~
DELETE -> DELETETERM VALUES